1111111111111111111111111111111111111111111111111111111111111111111111111111111111111111111111111111111111111111111111111111111111111111111111111111111111111111111111111111111111
100000000000000000000000000000000000000000000000000000000T00000000000000000000000000000000000000F000000000000000000000000000000000000000000T0000T000000000000000000000000000000001
10T00TT0000T0000T0T000000000T00000000000000000000000000000000000000000000000000000000000000000000000000000000000000000000000000000000000000000000000000000000000000000000000000001
100F0000000000F00000000000000000000000000000000000000000000C00000000000F000000000000000000000011111100000000000T0T0000000000000000000000000000000000000000000000000000000000000001
10000000C000000000000000000000000000000000000000000000011111110000000000000000000000000000000000000000000000000000000000000000000000000001111111111110000TT000T0T0000T000000000001
11111111111111111111111011111100000000000000000000000000000000000000001111110000F0000000000000000000000000000000000000000T0T000000000000000000000000000F00000000000000000001111111
10000000000000000000000000000000000111111000000000000000000000000000000000000000000000000000000000000000000000111111000000000000000000000000000000000000000000000C0000000000000001
100000000000000F000000000000000000000000000000000000000000000000000000000000001111100000011111100000000000000000000000000000000000000000000111111111111111111111111111111000000001
1000000000000000000000C00000000000000000000F000000000000000000011111100000000000000000000000000000000C000000000000000000011111100000000T000000000000000000000000000000000000000001
100T000000000111111111111000000000000000000000000000000000000000000000000000000000000000000000000011111100000000000000000000000000000000000000000000000000000000000000000000000001
1000000000000000000000000000000000000000111111100000000000000000000000000000000000000000000000000000000000000000000000000000000000000000000000000000000T0000000000000F000000000001
1000000000000000000000000F000000000000000000000000000000000000000000000000000000000T0000000000000000000T00000000000000000000P00E00000111111110000000000000000000000000000000000001
111111000000000000000000000000000000000000000T00000000000000T00000000000000000000F000000000000000000000000000000000000000000000000000000000000000000000000000000000111111100000001
10000000000000000000001111110000000000000000000000000000000000000000000000000000000C0000000000000000000000000000000000000000111110000000000000000000011111110000F00000000000000001
1000000000000000000000000000000000000000000000000000000000000000000000000T000000111111000000000000000111111100000000000000000000000000000000T0000000000000000000000000000000000001
10000000000000000000T000000000000000000000011111100000000011111100000000000000000000000000000000000000000000000000T000000000000000000000000000F00000000000000000000000000000000001
10000000000000000F0000000000000T00000000000000000000000000000000000000000000000000000000000T0TT00T00000000000000000000000000000000000000C00000000000000000000111111100000000000001
1000000000000000000C000000000000000000000000000000000000000000000000011111111111000000000000000000000000000000000000000000000000000000111111111111000000T0000000000000000000000001
100000000000000111111100000000000000000000000000000000T00T000000000000000000000000000000000000000000000000000000111111100000000000000000000000000000000000000000000000000000000001
100000000000000000000000000001111111100000000000000000000000000000000000000000000000000000011111111111000000000000000000000T000000000000000000000000000000000000000000000000000001
1000000000000000000000000000000000000000000000000000000C0000000000000000000000000000000000000000000000000000000000000000F0000000F0000000000000000000111111111110000000000000000001
10000000000000000000000000000000000000000000000000011111111110000000000000TT000000000000000000000000000000000000000000000000000000000000000000000000000000000000000000000000000001
1000000000001111111111000000000000000000000000000000000000000000000000000000000000000000000000000000000000000000000000011111111111110000000000000000000000000000000000000000000001
100000000000000000000000000000000000000000000000000000000000000000000000000000000000000000000T000000T00000000000000000000000000000000000000000000000000000000000000000000000000001
100000000000000000000000000000000000000000000000000000000000000000000000111111111000000000000000F000000000000000000000000000000000000000000000000000000000000000000000000000000001
1000000000000000000000000011111111111000000000000000000000000000000000000000000000000000000000000000000000000000000000000000000000000000000000000000000000000000000000000000000001
1000000000000000000000000000000000000000000000000000000000000000000000000000000000000000000011111111111000000000000000000000000000000000000000000000000000000000000000000000000001
1000000000000000000000000000000000000000000000000000000000000000000000000000000000000000000000000000000000000000000000000000000000000000000000000000000000000000000000000000000001
1000000000000000000000000000000000000000000000000000000000000000000000000000000000000000000000000000000000000000000000000000000000000000000000000000000000000000000000000000000001
1000000000000000000000000000000000000000000000000000000000000000000000000000000000000000000000000000000000000000000000000000000000000000000000000000000000000000000000000000000001
1000000000000000000000000000000000000000000000000000000000000000000000000000000000000000000000000000000000000000000000000000000000000000000000000000000000000000000000000000000001
1000000000000000000000000000000000000000000000000000000000000000000000000000000000000000000000000000000000000000000000000000000000000000000000000000000000000000000000000000000001
1000000000000000000000000000000000000000000000000000000000000000000000000000000000000000000000000000000000000000000000000000000000000000000000000000000000000000000000000000000001
1000000000000000000000000000000000000000000000000000000000000000000000000000000000000000000000000000000000000000000000000000000000000000000000000000000000000000000000000000000001
1000000000000000000000000000000000000000000000000000000000000000000000000000000000000000000000000000000000000000000000000000000000000000000000000000000000000000000000000011111111
1000000000000000000000000000000000000000000000000000000000000000000000000000000000000000000000000000000000000000000000000000000000000000000000000000000000000000000000000000000001
1000000000000000000000000000000000000000000000000000000000000000000000000000000000000000000000000000000000000000000000000000000000000000000000000000000000000000000000000000000001
1111111111111111111111111111111111111111111111111111111111111111111111111111111111111111111111111111111111111111111111111111111111111111111111111111111111111111111111111111111111