1111111111111111111111111111111111111111111111111111111111111111111111111111111111111111111111111111111111111111111111111111111111111111111111111111111111111111111111111111111111111111111111111111111111111111111
100000000000000000000000000000000000000000000000000000000T000000000000000000000000000000000000000000000000000000000000000000000000000000000000000000000000000000000000000000000000000F00000000000000000000000000001
10T00TT0000T0000T0T000000000T00000000000000000000000000000000000000000000000000000000000000000000000000000000000000000000000000000000000000000000000000000000000000000000000000000000000000000000000000000000000001
100F0000000000F0000000000000000000000T000000000000000000000C00000000000F000000000000000000000000000000000000000T0T0000000000000000000000000000000000000000000000000000000000000000111111111100000000000000000000001
10000000C0000000000000000000000000000000000000000000000111111100000000000000000000000000000000000000000000000000000000000000000000000000000000TT00000T00TT000T0T0000T000000000000000000000T00T0000T0000000000000001
11111111111111111111111011111100000000000000000000000000000000000T0T001111110000F0000000000000000000000000000000000000000T0T000000000000000000000000000F00000000000000000001111110000000000000000000000000000000001
10000000000000000000000000000000000111111000000000000000000000000000000000000000000000000000000000000000000000111111000000000000000000000000000000000000000000000C0000000000000000000000000000000000000000000000001
100000000000000F000000000000000000000000000000000000000000000000000000000000001111100000011111100000000000000000000000000000000000000000000111111111111111111111111111111000000000000000001111111111110000000000001
1000000000000000000000C00000000000000000000F000000000000000000011111100000000000000000000000000000000C000000000000000000011111100000000T00000000000000000000000000000000000000000TT00000000000000000000000000000001
100T00000000011111111111100000000000000000000000000000000000000000000000000000000000000000000000001111110000000000000000000000000000000000000000000000000000000000000T00T000000F00000000000000000000000000000000001
1000000000000000000000000000000000000000111111100000000000000000000000000000000000000000000000000000000000000000000000000000000000000000000000000000000T00000000000000000000000000000000000000000000000000T00T00T01
1000000000000000000000000F000000000000000000000000000000000000000000000000000000000T0000000000000000000T000000000000000000000PE0000001111111100000000000000000000000000000000011111111000000000000000000F0000000001
111111000000000000000000000000000000000000000T00000000000000T00000000000000000000F0000000000000000000000000000000000000000000000000000000000000000000000000000000001111111000000000000000000000000000000000000000C1
10000000000000000000001111110000000000000000000000000000000000000000000000000000000C0000000000000000000000000000000000000000111110000000000000000000011111110000T00000000000000000000000000000000000000111111111111
1000000000000000000000000000000000000000000000000000000000000000000000000T000000111111000000000000000111111100000000000000000000000000000000T00000000000000000F0000000000000000000000000000000000000000000000000001
10000000000000000000T100000000000000000000011111100000000011111100000000000000000000000000000000000000000000000000T000000000000000000000000000F0000000000000000000000000000000000000000000000000T00T00TT0T000000001
10000000000000000F0000000000000T00000000000000000000000000000000000000000000000000000000000T0TT00T00000000000000000000000000000000000000C0000000000000000000011111110000000000000000000000000000F000000000000000001
1000000000000000000C000000000000000F00000000000000000000000000000000011111111111000000000000000000000000000000000000000000000000000000111111111111000000T000000000000000000000000000000000000000000C000000000000001
10000000000000011111110000000000C000000000000000000000T00T00000000000000000000000000000000000000000000000000000011111110000000000000000000000000000000000000000000000000000T0T0TT0000000000011111111111111110000001
1000000000000T0000000000000001111111100000000000000000000000000000000000000000000000000000011111111111000000000000000000000T000000000000000000000000000000000000000000000000000000000000000000000000000000000000001
10000000000000000F0000000000000000000000000000000000000C0000000000000000000000000000000000000000000000000000000000000000F0000000F000000000000000000011111111111000000000000000C000000000000000000000000000000000001
10000000000000000000000000000000000000000000000000011111111110000000000000TT000000000000000000000000000000000000000000000000000000000000000000000000000000000000000000000111111111110000000T0T0TTT00000000000000001
1000000000001111111111000000T00T0T000000000000000000000000000000000000000000000F00000000000000000000000000000000000000011111111111110000000000000000000000000000T0T00000000000000000000000000F000000000000000000001
10000000000000000000000000000F0000000000000000000000000000000000000000000000C00000000000000000T000000T0000000000000000000000T0T00T00000TTT0T0T00T00000000000000000000000000000000000000000000000C000000000000000001
100000000000000000000000000000000000000000000000000000000000000000000000111111111000000000000000F00000000000000000000000000000F0000F00000F0000F0000000F0000000000000000000000T000T000000000111111111100000000000001
1000000000000000000000000011111111111000000000000000TTT00T00000000000000000000000000000000000000000000000000000000000000000000000000000000000C0000000000000001111111100000000000F0000000000000000000000000000000001
100000000000000000000000000000000000000000000000000F0000F0000000000000000000000000000000000011111111111000000T000T00T0000011111111111111111111111111111110000000000000000000000000000000000000000000000000000000001
100000000000000000000000T00000T000000000000000000000000000000C0000000000T00000T0000000000000000000000000000000000F00F0000000000000000000000000000000000000000000000000000000011111111110000000000000000000000000001
100000000000000000000000000F000000000000000000000011111111111110000000000000F00000000000000000000000000000000000000000000000000000000000000000000000T00T000T0000000000000000000000000000000000000000000000000000001
10000000000000000000000000000000000000000000000000000000000000000000000000000C000000000000000000000000000000111111111111000000000000000000000000000000F0000000000000000000000000000000000000000T0T00000000000000001
1000000000000000000000111111111110000000000000000000000000000000000000111111111111000000000000000000000000000000000000000000000000000000000000000000000000000000000000000000000000000000000000F00000000000000000001
100000000000000000000000000000000000000000000000000000000000000000000000000000000000000000000000000000000000000000000000000000000000TT000000000000011111111111000000000000000T000000000000000000000C000000000000001
1000000000T000T0T0TT000000000000000000000000F000000000000000000000000000000000000TT0000TT00T00T000T000000000000000000000000000000F000000000000000000000000000000000000000000F00000000000000001111111111100000000001
10000000000000F00000F0000000000000000000000000000000000000000000000000000000000000000000F0000000000F00000000000000000000000000000000000000000000000000000000000000000000000C000000000000000000000000000000000000001
100000000000000C00000000000000000000000111111111100000000000000000000000000000000C000000000000C0000000000000000000T00TT00000000001111111111000000000000000000000000000000011111110000000T0TT00000000000000000000001
100000011111111111111110000000000000000000000000000000000000000000000000000000000111111111111111111111110000000000000000F0000000000000000000000000000000000000000000000000000000000F00F0000000000000000000000000001
1000000000000000000000000000000000000000000000000000000000000000000000000000000000000000000000000000000000000000000000000000000000000000000000000000000000000000000000000000000000000000000000000000000000000000001
1000000000000000000000000000000000000000000000000000000000000000000000000000000000000000000000000000000000000000011111111111100000000000000000000TT000T00T000000000000000000000000111111111111110000000T00000T00001
1000000000000000000000000000000000000000000000000000000000000000000000000000000000000000000000000000000000000000000000000000000000000000000000000000F00000000000000000T0000T000T0TT00000000000000000000000F00000001
10000000000T0000000000000000000000000000000000000000000000000000T000T0T000T000000000000000000000000000000000000000000000000000000000000000000000000000000C000000000000000F0000000000000000000000000000C000000000001
10000000000000000000000000000000000000000000000000000000000000000000000000000000000000000000000000000000TTTT0000000000000000000000000000000000011111111111111110000000C00000000000000000000000000000001111111111111
100000000000000000000T00T0TT0T00000000000000000000000000000000000000000000000000000000000000000000000000000000F0000000000000000000T000TT00T000000000000000000000011111111111111111111100000000000000000000000000001
10000000011111100000F0000000F0000000000000000000000000000011111111111111111111110000000000000000000000000C00000000000000T00T00000000F000000F000000000000000000000000000000000000000000000TTTTTT00T00000000000000001
10000F00000000000000000000000000000000000T000TT0000T0000000000000000000000000000000000000000000000000011111111111000T000000F000000000000C00000000000T00T00T00000000000000000000F000F0000000000000000000000000000001
10000000000000C01111111111111111000000000F000F0000F0000F000000F000F00F0000000000000000000000000000000000000000000000000000000000111111111111111100000000000000000000000000000000000000000000C0000000000000000000001
10000111111111110000000000000000000000000000000000000000000C0000000000000000000000000000000000000000T000T000T00T0000000011111110000000000000000000000000000000000T0T00TT0001111111111111111111111111000000000000001
10000000000000000000000000000000000001111111111111111111110101111111111110000000000000000000F00F0000F00000F00F0000111110000000000000000C000000000111111111111100000000000000000000000000000000000000000000000000001
1000000000000000000000000000000000000000000000000000000000000000000000000000000000000000000000000000000000000000000000000000000000111111111111110000000000000000000000000000000000000000000000000000000000000000001
1000000000000000000000000000000000000000000000000000000000000000000000000000000000000000011111111111111111111111110000000000000000000000000000000000000000000001111111111110000000000000000000000000000000000000001
1000000000000000000000000000000000000000000000000000000000000000000000000000000000000000000000000000000000000000000000000000000000000000000000000000000000000000000000000000000000000000000000000000000000000000001
1111111111111111111111111111111111111111111111111111111111111111111111111111111111111111111111111111111111111111111111111111111111111111111111111111111111111111111111111111111111111111111111111111111111111111111